####################
#..................#
#..................#
#.............#....#
#.....#########....#
#..................#
####...........#...#
#......###...###...#
#.S.............S..#
#....###...........#
#..........####....#
#.............###..#
#####.........#....#
#..................#
#.........#........#
#.....########.....#
#..................#
#..................#
#..................#
####################