####################
#..................#
#.....#.....#......#
#..S.....#.....#...#
#..................#
#.....#.....#......#
#..#.....#.....#...#
#..................#
#.....#.....#......#
#..#.....#.....#...#
#..................#
#.....#.....#......#
#..#.....#.....#...#
#..................#
#.....#.....#......#
#..#.....#.........#
#...............S..#
#.....#.....#......#
#..................#
####################