####################
#..................#
#..................#
#..................#
#..................#
#..................#
#..................#
#.........S........#
#..................#
#..................#
#..................#
#..................#
#.........S........#
#..................#
#..................#
#..................#
#..................#
#..................#
#..................#
####################