####################
#..................#
#..................#
#.............#....#
#.....#########....#
#..................#
#..............#...#
####...##....###...#
#..................#
#......#.........S.#
#...S..#...####....#
#.............###..#
#####.........#....#
#..................#
#..................#
#.....########.....#
#..................#
#..................#
#..................#
####################