####################
#..................#
#........S.........#
#.............#....#
#.....#########....#
#..................#
#..............#...#
####...###...###...#
#......#...........#
#......#...........#
#......#...####....#
#.............###..#
#####.........#....#
#..................#
#.........#........#
#.....########.....#
#..................#
#........S.........#
#..................#
####################